6 6 6 6 6 6 6 6 6 6 6 6 6 6 6 6 6 6 6
6 0 0 0 0 0 0 0 0 0 0 0 0 0 0 0 0 0 6
6 0 0 0 0 0 0 0 0 0 0 0 0 0 0 0 0 0 6
6 0 0 0 0 0 0 0 0 0 0 1 2 3 4 0 0 6
6 0 0 0 0 0 0 0 0 0 0 0 0 0 0 0 0 0 6
6 0 0 0 0 0 1 2 4 0 0 0 0 0 0 0 0 0 6
6 0 0 0 0 0 0 0 0 0 0 0 0 1 2 3 4 0 6
6 0 0 0 0 0 0 0 0 0 0 0 0 0 0 0 0 0 6
5 5 5 5 5 5 5 5 5 5 5 5 5 5 5 5 5 5 5